jr_map_1.map	50	50
11111111111111111111111111111111111111111111111111
11111111111111111111111111111111111111111111111111
11111111111111111111111111111111111111111011111111
11111111111111111111111111111111100011111011111111
11111111110111111111111111111111101011111100111111
11111111110111111111111111111111100011111111001111
11111111110111111111111111111111111111111111110011
11111111110111111111111111111111111111111111111111
11111111110000000000011111111111111111111111111111
11111111110111111111111111111111111111111111111111
11111111110111111111111111111111111111111111111111
11111111110111111111111111111111111111111111111111
11110000000111111111111111111111111111111111111111
11111111111111111111111111111111111111111111111111
11111111111111111111111111111111111111111111111111
11111111111111111111111110111111111111111111111111
11111111111111111111111101111111111111111111111111
11111111111111111111111011111111111111111111111111
11111111111111111111110111111111111111111111111111
11111111111111111111101111100000000000000000000111
11111111111111111111011111111101111101111011110111
11111111111111111110111111101101101101101011110111
11111111111111111111111111101101101101101010110111
11111111111111111111111111101111101111101010110111
01110011001100001111100000000000000000101010110111
11111111111111101111100000011111111110101010110111
11111111111111101111100000111111111110101010110111
11111111111111101111100001111011111110101010110111
11111111111111101111100011111011111110101010110111
11111111111111101111100111111011111110101110110111
11000111111111101111101111111011100000000010110111
11110111111111101111101111111011111111111010110111
11110000000001101111101111111011111111111000110111
11111111111101101111101111111011111111111011110111
11111111111101101111101111111011100000000011110111
11111111111101101111111111111011111011111111110111
11110000000001100001111111111011111011111111110111
11110111111111111101110000000011111011111111111111
11110111111111111101110111111111111011111111111111
11110111000000001101110111111111100011111111111111
11110111011111101100000111011111111111111111111111
11110111011111101111111111011111111110000000000011
11110111011111101111111111011111111111111110111111
11110111011111101111111111011000000111111110111111
11110111011111100000000000011111011111111110111111
11110111011111101111011111111111011111111110111111
11110111000110001111011111111111011111111110111111
11110111110110111111011111111111011111111111111111
11110001111111111111011111111111011111111111111111
11111100000000000000000000000000011111111111111111
