jr_map_3.map	100	100
1111111111111111111111111111111111111111111111111011111101111111111111111111111100000000000000000000
1111111111111111111111111111111111111111111111111011111101111111111111111111111101111111111111111110
1111111111111111111111111111111111111111110111111011111100000000000000111111111101111111111111111110
1111111111111111111111111111111111111111110111111011111111111111111110111111111101111111111111111110
1111111111111111111111111111111111111111110110000011111111111111111110111111111101101111111111111110
1111111111111111111111111111111111111111110111111111111111111111111110111111111101101111111111111110
1111111111111111111111111111111111111111110111111111000000000000111111111101111101100000000000000110
1111111111111111111111111111111111111110000000000011011111111110111111111101111101101111111111110110
1111111111111111111111111111111111111110222211111111011111111110111111111101111101101111111111110110
1111111111111111111111111111111111111110222211111111000111111000111111111101111101101122222211110110
1111111111111111111111111111111111111110000000011111110111111011111111111101111101111122222211110110
1111111111111111111111111111111111111111111111011111000111111000111111111101111101111122222211110110
1111111111111111111111111111111111111111111111000011011111111110111000000001111101111122222211110110
1111111111111111111111111111111111111111111111011111011111111110111111111101111100000000000000000110
1111111111111111111111111111111111111111111111011111011111111110111111111101111111111111111111111110
1111111111111111111111111111111111111111111111011100011111111110111111111101111111111111111111111110
1111111111111111111111111111111111111111111111011111111111111110111111111101111111111111111111111110
1111111111111111111111111111111111111111111111011111111111111110111000000000000000110000000000000000
1111111111111111111111111111111111111111111111011111111111111110111111111111111110110111111111111111
1111111111111111111111111111111111111111111111011100000000000000111111111111111110110111111111111111
1111111111111111111111111111111111111111111111011101111111111111111111111111111110110111111111111111
1111111111111111111111111111111111111111111111011101111111111111111111111111111110110000000000001111
1111111111111111111111111111111111111111111111011101111111111111111011111110000000111111111111111111
1111111111111111111111111111111111111111111111011100000000000000000011111110111111111111111111111111
1111111111111111111111111111111111111111111111011111111111111111111011111110111111111111111111100000
1111111111111111111111111111111111111111111111011111111111111111111000000000111111011111111111111111
1111111111111111111111111111111111111111111111011111111111111111111011111111111100000011101111111111
1111111111111111111111111111111111111111111111111111111111111111011011111111111111111011101111111111
1111111111111111111111111111111111111111111111111111111111111111011000000000111111111011101111111111
1111111111111111111111111111111111111111111111111111111111111111010011111110000000111011100000011111
1111111111111111111111111111111111111111111111111111111111111111011011111111111011111011111111011111
1111111111111111111111111111111111111111111111111111111111111111011011111011111011111011111111000001
1111111111111111111111111111111111111111111111111111111111111111011011111011111011111011111111011101
1111111111111111111111111111111111111111111111111111111111111111011111111011111011111011111111011101
1111111111111111111111111111111111111111111111111111111111111111011111111011111011111000000011011101
1111111111111111111111111111111111111111111111111111111111111111011111111011111111111011111111011101
1111111111111111111111111111111111111111111111111111111111111111000000000011000000111011111111011101
1111111111111111111111111111111111111111111111111111111111111111111111111011011111111011111111011101
1111111111111111111111111111111111111111111111111111111111111111111111111011011111111011111111011101
1111111111111111111111111111111111111111111111111111111111111111111111111011011100011011111111011101
1111111111111111111111111111111111111111111111111111111111111111111111111111011111000011111111011101
1111111111111111111111111111111111111111111111111111111111111111111111111111011111011111111111011101
1111111111111111111111111111111111111111111111111111111111111111111111100000000111011111111111011101
1111111111111111111111111111111111111111111111111111111111111111111111111111111111011111111111011101
1111111111111111111111111111111111111111111111111111111111111111111111111111111111011111111111011101
1111111111111111111111111111111111111111111111111111111111111111111111111111111111011111111111011101
1111111111111111111111111111111111111111111111111111111111111111111111111111111111011111111111011101
1111111111111111111111111111111111111111111111111111111111111111111111111111111111011111111111011101
1111111111111111111111111111111111111111111111111111111111111111111111111111111111111111111111011111
1111111111111111111111111111111111111111111111111111111111111111111111111111111111111111111111011111
1111111111111111111111111111111111111111111111111111111111111111111111111111111111111111111111011111
1111111111111111111111111111111111111111111111111111111111111111111111111111111111111111111111011111
1111111111111111111111111111111111111111111111111111111111111111111111111111111111111111111111011111
1111111111111111111111111111111111111111111111111111111111111111111111111111111111111111111111111111
1111111111111111111111111111111111111111111111111111111111111111111111111111111111111111111111111111
1111111111111111111111111111111111111111111111111111111111111111111111111111111111111111111111111111
1111111111111111111111111111111111111111111111111111111111111111111111111111111111111111111111111111
1111111111111111111111111111111111111111111111111111111111111111111111111111111111111111111111111111
1111111111111111111111111111111111111111111111111111111111111111111111111111111111111111111111111111
1111111111111111111111111111111111111111111111111111111111111111111111111110000011111111111111111111
1111111111111111111111111111111111111111111111111111111111111111111111111110111011111111111111111111
1111111111111111111111111111111111111111111111111111111111111111111111111110111011111111111111111111
1111111111111111111111111111111111111111111111111111111111111111111111111110111011111111111111111111
1111111111111111111111111111111111111111111111111111111111111111111111111110111011111111111111111111
1111111111111111111111111111111111111111111111111111111111111111111111111110111011111111111111111111
1111111111111111111111111111111111111111111111111111111111111111111111111110111000000000000111111111
1111111111111111111111111111111111111111111111111111111111111111111111111110111111111111110111111111
1111111111111111111111111111111111111111111111111111111111111111111111111110111111111111110111111111
1111111111111111111111111111111111111111111111111111111111111111111111111110000000011011110111111111
1111111111111111111111111111111111111111111111111111111111111111111111111111111111111011110111111111
1111111111111111111111111111111111111111111111111111111111111111111111111111111111111011110111111111
1111111111111111111111111111111111111111111111111111111111111111111111111111111111111011000000001111
1111111111111111111111111111111111111111111111111111111111111111111111111111111111111011111111111111
1111111111111111111111111111111111111111111111111111111111111111111111111111111111111011111111111111
1111111111111111111111111111111111111111111111111111111111111111111111111111111111111011111111111111
1111111111111111111111111111111111111111111111111111111111111111000000000000000000000000110111111111
1111111111111111111111111111111111111111111111111111111111111111011111111111111111111110110111111111
1111111111111111111111111111111111111111111111111111111111111111011000000000000000000010110111111111
1111111111111111111111111111111111111111111111111111111111111111011011111111111111111010110111111111
1111111111111111111111111111111111111111111111111111111111111111011011000000000000001010110111111111
1111111111111111111111111111111111111111111111111111111111111111011011011111111111101010110111111111
1111111111111111111111111111111111111111111111111111111111111111011011011000000000101010110111111111
1111111111111111111111111111111111111111111111111111111111111111011011011011111110101010110111111111
1111111111111111111111111111111111111111111111111111111111111111011011011011000010101010110111111111
1111111111111111111111111111111111111111111111111111111111111111011011011011011010101010110111111111
1111111111111111111111111111111111111111111111111111111111111111011011011011011110101010110111111111
1111111111111111111111111111111111111111111111111111111111111111011011011011000000101010110111111111
1111111111111111111111111111111111111111111111111111111111111111011011011011111111101010110111111111
1111111111111111111111111111111111111111111111111111111111111111011011011000000000001010110111111111
1111111111111111111111111111111111111111111111111111111111111111011011011111111111111010110111111111
1111111111111111111111111111111111111111111111111111111111111111011011000000000000000010110111111111
1111111111111111111111111111111111111111111111111111111111111111011011111111111111111110110111111111
1111111111111111111111111111111111111111111111111111111111111111011000000000000000000000110111111111
1111111111111111111111111111111111111111111111111111111111111111011111111111111111111111110111111111
1111111111111111111111111111111111111111111111111111111111111111000000000000000000000000000111111111
1111111111111111111111111111111111111111111111111111111111111111111111111111111111111111111111111111
1111111111111111111111111111111111111111111111111111111111111111111111111111111111111111111111111111
1111111111111111111111111111111111111111111111111111111111111111111111111111111111111111111111111111
1111111111111111111111111111111111111111111111111111111111111111111111111111111111111111111111111111
1111111111111111111111111111111111111111111111111111111111111111111111111111111111111111111111111111
