jr_map_2.map	50	50
11111111111111111111111111111111111111111111111111
11110111111111111111111111111111111111111111111011
11011110111101011110110101111111101101111001110101
11111111111111111111111111011022221011011111111111
11111111111111111110111111011222221001111101111111
11111111111111110111111111110222220011111111101101
11111011111101111111111011110222222210110110111111
11011111100111111111110111122220222211111111111111
11111111111111111110111101122222222211111110111111
11111101111111011111011111122222222211010111111001
10111111111000111111111101111111101111111111111011
11111111111111110110011111010110111111011111111111
10111111111111111101111111111101111111011111110111
11111111111111011111111110111110111111111111101101
11111101110111111111111101111111111100111111111111
11111111111111101111011101111010011111101000111111
11011111011111111011111101011111101111111110111111
11111111111111111101101011111111011110111111110011
11011111110101101111111101111111111110101111111111
11111111111111111111110101111110111011101111011111
11101011111111101111111011101011111011111111101111
11111101111111111101111111011011111111111111111101
11111101101110111111111111101111111111111111111111
11111111101011011111101110111111110111110110110011
11101111111111111111111111111111111111111101111101
11111111111001111111110111011110111111110110111111
11110100111111001110101111011110011111111111010111
11111111110111111111111111011110111110110111111111
10111111111111111111111111111111110111011111100110
11111011110111110111110111011111111111111110111011
11111111111110111110111111010111111110111111110111
11111111111101111010011111000111001111111011111111
11110111111111100111111011111111111100101111111111
11011011111111111010111101111110111011011011111111
11111110111111111110111111111111011111111111111111
11110111100111111010111111111111111101111010110111
11111111100111011111111001111111110110110110111111
11111111011101101111011111100110111111010111101101
11111111111111111111111111110001111111111111111000
11111111111101100111111111111111111111111011111011
11111011111110010111111001111111010111011101111111
11111111111110110111101010111111101101111101111111
11111111111111111101111111111111111111111111110101
11011101101111111111111101101110101110111011101111
11111110111111111110111111110111111111110111110111
11011111111101111110110111111101011111111111100111
11111111101111111111111111111111111101011101111111
11101111111111110111111111111111101111100111011111
11101111111111111101111101111110011111111111101111
11111111111111111111111111101111111111110111111111
